59 59 59 59 59 59 59 59 59 59 59 59 59 59 59 59 59 59 59 59 59 59 59 59 59 59 59 59 59 59 59 59 59 59 59 59 59 59 59 59 59 59 59 59 59 59 59 59 59 59 59 59 59 59 59 59 59 59 59 59
59 59 59 59 114 59 59 59 59 59 59 59 59 59 59 59 59 59 59 59 59 59 114 114 114 114 59 59 59 59 59 59 59 59 59 59 59 59 59 59 59 59 59 59 59 59 59 59 59 59 59 59 59 59 59 59 59 59 59 59
59 59 59 114 114 114 114 114 114 114 114 114 114 59 59 59 59 59 59 59 59 59 114 114 114 59 59 59 59 59 59 59 59 59 59 59 59 59 59 59 59 59 59 59 59 59 59 59 59 59 59 59 59 59 59 59 59 59 59 59
59 59 114 114 114 114 114 114 114 114 114 114 114 59 59 59 59 59 59 59 59 59 114 114 114 59 59 59 59 59 59 59 59 59 59 59 59 59 59 59 59 59 59 59 59 59 59 59 59 59 59 59 59 59 59 59 59 59 59 59
59 59 114 114 114 59 59 59 59 59 114 114 114 114 59 59 59 59 59 59 59 59 114 114 114 59 59 59 59 59 59 59 59 59 59 59 59 59 59 59 59 59 59 59 59 59 59 59 59 59 59 59 59 59 59 59 59 59 59 59
59 59 114 114 114 59 59 59 59 59 59 114 114 114 59 59 59 59 59 59 59 59 114 114 114 59 59 59 59 59 59 59 59 59 59 59 59 59 59 59 114 114 114 59 59 59 59 59 59 59 59 59 59 59 59 59 59 59 59 59
59 114 114 114 59 59 59 59 59 59 59 59 114 114 59 59 59 114 59 59 59 59 114 114 59 59 59 59 59 59 59 59 59 59 59 59 59 59 59 59 114 114 114 114 59 59 59 59 59 59 59 59 59 59 59 59 59 59 59 59
59 59 114 114 114 59 59 59 59 59 59 59 114 114 59 59 59 114 114 59 59 114 114 114 114 114 114 114 114 114 114 59 59 59 59 59 59 59 59 114 114 114 114 114 59 59 59 114 114 114 114 59 59 59 59 59 59 59 59 59
59 59 114 114 114 59 59 59 59 59 59 114 114 114 114 59 59 59 114 59 59 114 114 114 59 59 59 59 114 114 114 114 114 59 59 59 59 59 59 114 114 114 114 114 114 114 114 114 114 114 114 114 59 59 59 59 59 59 59 59
59 59 114 114 114 114 59 59 59 59 114 114 114 114 114 59 59 59 114 59 59 114 114 59 59 59 59 59 114 114 114 114 114 114 59 59 59 59 59 59 59 114 114 114 114 114 114 114 114 114 114 114 114 59 59 59 59 59 59 59
59 59 59 114 114 114 59 59 59 59 114 114 114 114 59 59 59 59 114 114 114 114 114 59 59 59 59 59 59 59 59 114 114 114 114 59 59 59 59 59 59 114 114 114 114 114 114 114 114 114 114 114 114 59 59 59 59 59 59 59
59 59 59 114 114 114 114 114 59 59 114 114 114 59 59 59 59 59 114 114 114 114 114 59 59 59 59 59 59 59 59 59 114 114 114 114 59 59 59 59 114 114 114 114 114 114 114 114 114 59 114 114 114 114 59 59 59 59 59 59
59 59 59 59 114 114 114 114 59 59 59 59 59 59 59 59 114 114 114 114 114 114 59 59 59 59 59 59 59 59 59 59 59 114 114 114 114 59 114 114 114 114 114 59 59 59 114 114 114 59 59 114 114 114 59 59 59 59 59 59
59 59 59 59 59 114 114 114 59 59 59 59 59 59 59 59 114 114 114 114 114 114 114 59 59 59 59 59 59 59 59 59 59 59 114 114 114 114 114 114 114 114 114 59 59 114 114 114 114 59 59 114 114 114 114 59 59 59 59 59
59 59 59 59 59 59 114 114 114 59 59 59 59 59 59 114 114 114 114 114 114 114 114 59 59 59 59 59 59 59 59 59 59 59 59 114 114 114 114 114 59 59 59 59 59 114 114 114 114 59 59 114 114 114 114 59 59 59 59 59
59 59 59 59 59 59 114 114 114 114 114 114 59 59 114 114 114 114 59 114 114 114 59 59 59 59 59 59 59 59 59 59 59 114 114 114 114 114 114 114 59 59 59 59 59 59 114 114 59 59 59 59 114 114 114 59 59 59 59 59
59 59 59 59 59 59 114 114 114 114 114 114 114 114 114 114 59 59 59 114 114 114 59 59 59 59 59 59 59 59 59 114 114 114 114 114 114 114 114 114 59 59 59 59 59 59 59 59 59 59 59 59 114 114 114 114 59 59 59 59
59 59 59 59 59 59 59 114 114 114 114 114 114 114 114 114 59 59 59 114 114 114 59 59 59 59 59 59 114 114 114 114 114 114 114 114 114 114 114 59 59 59 59 59 59 59 59 59 59 59 59 59 114 114 114 114 59 59 59 59
59 59 59 59 59 59 59 59 59 59 59 59 59 59 59 59 59 59 114 114 114 114 114 114 114 59 59 59 114 114 114 114 114 114 114 114 114 59 59 59 59 59 59 59 59 59 59 59 59 59 59 59 114 114 114 59 59 59 59 59
59 59 59 59 59 59 114 114 114 114 114 114 114 114 114 114 114 114 114 114 114 114 114 114 114 114 114 114 114 114 114 114 114 114 114 59 59 59 59 59 59 59 59 59 59 59 59 59 59 59 114 114 114 114 59 59 59 59 59 59
59 114 114 114 114 114 114 114 114 114 114 114 114 114 114 114 114 114 114 114 114 114 114 114 114 114 114 114 114 114 59 114 114 114 114 114 59 59 59 59 59 59 59 59 114 114 114 114 114 114 114 114 114 114 114 59 59 59 59 59
59 114 114 114 114 114 114 114 114 114 114 114 114 114 114 114 114 114 114 114 114 114 114 114 59 59 59 59 59 59 59 59 114 114 114 114 59 59 59 114 114 114 114 114 114 114 114 114 114 114 114 114 114 114 114 114 59 59 59 59
59 114 114 114 114 114 114 114 114 114 114 114 114 114 114 114 114 114 59 59 59 59 59 59 59 59 59 59 59 114 114 114 114 114 114 59 59 59 59 114 114 114 114 114 114 114 114 114 114 114 114 114 114 114 114 114 114 59 59 59
59 114 59 59 59 59 59 59 59 59 59 59 59 114 114 114 59 59 59 59 59 59 59 59 59 59 59 59 114 114 114 114 114 59 59 59 59 59 59 114 114 114 114 114 114 114 114 114 114 114 114 114 114 114 114 114 114 59 59 59
59 59 59 59 59 59 59 59 59 59 59 59 114 114 114 59 59 59 59 59 59 59 59 59 59 59 59 59 114 114 114 114 114 59 59 59 59 59 114 114 114 114 114 114 114 114 114 114 114 114 114 114 114 114 114 114 114 59 59 59
59 59 59 59 59 59 59 59 59 59 59 59 114 114 114 59 59 59 59 59 59 59 59 59 59 59 59 59 59 114 114 114 59 59 59 59 59 59 114 114 114 114 114 114 114 114 114 114 114 114 114 114 114 114 114 114 114 114 59 59
59 59 59 59 59 59 59 59 59 59 59 114 114 114 114 59 59 59 59 59 59 59 59 59 59 59 59 59 59 59 59 59 59 59 59 59 59 59 114 114 114 114 114 114 114 114 114 114 114 114 114 114 114 114 114 114 114 114 59 59
59 59 59 59 59 59 59 59 59 59 59 114 114 114 59 59 59 59 59 59 59 59 59 59 59 59 59 59 59 59 59 59 59 59 59 59 59 59 114 114 114 114 114 114 114 114 114 114 114 114 114 114 114 114 114 114 114 114 59 59
59 59 59 59 59 59 59 59 59 59 59 114 114 114 59 59 59 59 59 59 59 59 59 59 59 59 59 59 59 59 59 59 59 59 59 59 59 59 114 114 114 114 114 114 114 114 114 114 114 114 114 114 114 114 114 114 114 114 59 59
59 59 59 59 59 59 59 59 59 59 59 114 114 114 114 59 59 59 59 59 59 59 59 59 114 114 59 59 59 59 59 59 59 59 59 59 59 59 114 114 114 114 114 114 114 114 114 114 114 114 114 114 114 114 114 114 114 114 59 59
59 59 59 59 59 59 59 59 59 59 59 114 114 114 114 114 59 59 59 59 59 59 59 114 114 114 114 59 59 59 59 59 59 59 59 59 59 59 114 114 114 114 114 114 114 114 114 114 114 114 114 114 114 114 114 114 114 114 59 59
59 59 59 59 59 59 59 59 59 59 59 114 114 114 114 114 114 114 59 59 59 59 59 114 114 114 114 114 59 59 59 59 59 59 59 59 59 59 114 114 114 114 114 114 114 114 114 114 114 114 114 114 114 114 114 114 114 114 59 59
59 59 59 59 59 59 59 59 59 59 114 114 114 114 114 114 114 114 59 59 59 59 59 59 114 114 114 114 59 59 59 59 59 59 59 59 59 59 114 114 114 114 114 114 114 114 114 114 114 114 114 114 114 114 114 114 114 114 59 59
59 59 59 59 59 114 114 59 59 114 114 114 59 59 59 114 114 114 114 59 59 59 114 114 114 114 114 59 59 59 59 59 59 59 59 59 59 59 114 114 114 114 114 114 114 114 114 114 114 114 59 59 114 114 114 114 114 59 59 59
59 59 59 59 59 59 114 114 114 114 114 114 59 59 59 114 114 114 114 114 114 114 114 114 114 114 114 59 59 59 59 59 59 59 59 59 59 59 59 114 114 114 114 114 114 114 114 114 114 59 59 59 59 59 59 59 59 59 59 59
59 59 59 59 59 59 114 114 114 114 114 59 59 59 114 114 114 59 114 114 114 114 114 114 114 59 59 59 59 59 59 59 59 59 59 59 59 59 59 59 114 114 114 114 114 114 114 114 114 114 59 59 59 59 59 59 59 59 59 59
59 59 59 59 59 59 114 114 59 59 59 59 59 59 114 114 114 114 114 114 114 59 59 114 114 59 59 59 59 59 59 59 59 59 59 59 59 59 59 59 59 59 59 59 59 59 114 114 114 114 114 114 114 114 114 114 114 114 59 59
59 59 59 59 59 59 59 59 59 59 59 59 59 59 114 114 114 114 114 114 59 59 59 59 59 59 59 59 59 59 59 59 59 59 59 59 59 59 59 59 59 59 59 59 59 59 59 114 114 114 114 114 114 114 114 114 114 114 59 59
59 59 59 59 59 59 59 59 59 59 59 59 59 59 114 114 114 59 114 59 59 59 59 59 59 59 59 59 59 59 59 59 59 59 59 59 59 59 59 59 59 59 59 59 59 59 59 59 114 114 114 114 114 114 114 114 114 114 59 59
59 59 59 59 59 59 59 59 59 59 59 59 59 59 59 59 59 59 59 59 59 59 59 59 59 59 59 59 59 59 59 59 59 59 59 59 59 59 59 59 59 59 59 59 59 59 59 59 59 59 59 59 59 59 59 59 59 59 59 59