59 59 59 59 59 59 59 59 59 59 59 59 59 59 59 59 59 59 59 59 59 59 59 59 59 59 59 59 59 59 59 59 59 59 59 59 59 59 59 59 59 59 59 59 59 59 59 59 59 59 59 59 59 59 59 59 59 59 59 59
59 114 114 114 114 114 114 114 114 114 114 114 114 114 114 114 114 114 114 114 114 114 114 114 114 114 114 114 114 114 114 114 114 114 114 114 114 114 114 114 114 114 114 114 114 114 114 114 114 114 114 114 114 114 114 114 114 114 114 59
59 114 114 114 114 114 114 114 114 114 114 114 114 114 114 114 114 114 114 114 114 114 114 114 114 114 114 114 114 114 114 114 114 114 114 5 114 114 114 114 114 114 5 114 114 114 114 114 114 114 114 114 114 114 114 114 114 114 114 59
59 114 114 5 114 114 114 114 114 114 114 114 5 5 114 114 5 5 114 114 114 114 114 114 114 114 114 114 114 114 114 114 114 114 114 5 114 114 114 114 114 5 5 114 114 114 114 114 114 114 14 114 114 114 114 114 114 114 114 59
59 114 114 5 5 114 114 114 114 114 114 5 5 114 114 114 114 5 114 114 114 114 114 114 114 114 114 114 114 114 114 14 114 114 5 5 114 114 114 114 114 5 114 114 114 114 114 114 114 114 114 114 114 114 114 114 114 114 114 59
59 114 114 114 5 5 114 114 114 114 114 5 114 114 114 114 114 114 114 114 114 114 114 114 114 114 114 114 114 114 114 114 114 114 5 114 114 114 114 114 5 5 114 114 14 114 114 114 114 114 114 114 114 114 114 114 114 114 114 59
59 114 114 114 114 5 114 114 114 114 114 5 114 114 14 114 114 114 114 114 114 114 114 114 114 114 114 114 114 114 114 114 114 114 5 114 114 114 114 114 114 114 114 114 114 114 114 114 114 114 114 114 114 114 114 114 114 114 114 59
59 114 114 14 114 5 5 5 114 114 114 5 5 114 114 5 114 114 114 114 114 5 5 114 14 114 114 114 114 114 114 114 114 5 5 114 114 114 114 114 114 114 114 114 5 5 5 114 114 114 114 114 114 114 114 114 114 114 114 59
59 114 114 114 114 114 114 5 114 114 114 114 114 114 114 5 114 114 114 114 114 114 5 5 114 114 114 114 114 114 114 114 5 5 114 114 114 114 114 114 14 114 114 5 5 114 114 114 114 114 114 114 114 114 114 114 114 114 114 59
59 114 114 114 114 114 114 114 114 114 114 114 114 114 5 5 114 114 114 114 114 114 114 5 5 5 114 114 114 14 114 114 5 114 114 114 114 114 114 114 114 5 5 5 114 114 114 114 114 114 114 114 114 114 114 114 114 114 114 59
59 114 114 5 5 114 14 114 114 114 114 114 114 5 5 114 114 114 5 114 114 114 114 114 114 5 114 114 114 114 114 5 5 114 114 114 114 114 114 114 114 5 114 114 114 14 114 114 114 114 5 5 114 14 114 114 114 114 114 59
59 114 114 5 114 114 114 114 114 114 114 114 114 5 114 114 114 114 5 114 114 114 114 14 114 114 114 114 114 114 114 114 114 114 114 114 114 114 114 114 114 114 114 114 5 114 114 114 114 114 114 114 114 114 5 114 114 114 114 59
59 114 5 5 114 114 114 114 114 114 114 114 114 114 114 114 114 114 5 114 114 114 114 114 114 114 15 15 114 114 114 114 114 114 114 15 114 114 114 14 114 114 5 5 5 114 114 114 114 114 114 114 114 5 5 114 114 114 114 59
59 114 114 114 14 114 114 114 15 15 114 114 114 114 114 14 114 114 114 114 114 114 114 114 114 15 15 114 114 114 114 114 114 114 114 15 15 114 114 114 114 114 5 114 114 114 114 114 114 114 14 114 5 5 114 114 114 114 114 59
59 114 114 114 114 114 114 114 15 114 114 114 114 114 114 114 114 114 14 114 114 114 15 15 15 15 114 114 114 114 114 114 114 114 114 114 15 15 15 15 15 15 114 114 114 114 114 5 5 114 114 114 5 114 114 114 114 114 114 59
59 114 114 5 114 114 114 15 15 114 114 114 114 5 5 5 114 114 114 114 114 114 114 114 114 114 114 114 114 4 4 4 114 114 114 114 114 114 114 114 114 114 114 114 114 114 114 5 114 114 114 114 114 114 114 14 114 114 114 59
59 114 5 5 114 114 15 15 114 114 114 114 114 114 114 5 5 114 15 114 114 114 114 114 114 114 114 114 114 114 114 4 4 114 114 114 114 114 114 114 114 114 114 114 114 114 114 114 114 114 114 14 114 114 114 114 114 114 114 59
59 114 5 114 114 114 15 114 114 114 114 114 114 114 14 114 114 114 15 114 114 114 114 114 114 114 4 4 4 4 114 114 4 4 114 114 114 114 4 4 114 114 114 114 114 15 15 114 114 114 114 114 114 114 114 114 114 114 114 59
59 114 114 114 15 15 15 114 114 114 5 5 114 114 114 114 114 15 15 114 114 114 114 114 114 4 4 114 114 114 114 114 114 114 4 4 4 114 114 4 4 114 114 114 114 114 15 114 114 14 114 114 114 114 114 114 114 114 114 59
59 114 114 114 114 114 114 114 114 114 114 5 5 5 5 114 15 15 114 114 114 114 114 114 4 4 114 114 114 114 114 114 114 114 114 114 114 114 114 114 4 4 114 114 114 114 15 15 114 114 114 114 114 114 114 114 114 14 114 59
59 114 114 114 114 114 114 114 114 114 114 114 114 114 5 114 15 114 114 114 114 114 114 114 4 114 114 114 114 114 114 114 114 114 114 114 114 114 114 114 114 4 4 114 114 114 114 15 15 114 114 114 114 14 114 114 114 114 114 59
59 114 114 114 114 114 114 114 114 114 114 114 114 114 114 114 114 114 114 114 114 114 114 4 4 114 114 114 114 114 114 114 114 114 114 114 114 114 114 114 114 114 114 114 114 114 114 114 15 15 15 15 114 114 114 114 114 114 114 59
59 114 114 5 5 114 14 114 114 114 114 114 114 114 114 114 114 114 114 114 4 114 4 4 114 114 114 114 114 114 114 114 114 114 15 15 114 114 114 114 114 114 114 114 114 114 114 114 114 114 114 114 114 114 114 114 114 114 114 59
59 114 114 114 5 5 114 114 15 15 15 15 114 114 114 114 114 114 114 114 4 4 4 114 114 114 114 114 114 114 114 114 114 114 114 15 15 15 114 114 114 114 114 114 114 114 114 114 114 114 114 114 114 114 114 114 114 114 114 59
59 114 114 114 114 114 114 114 114 114 114 15 15 15 15 114 114 114 114 114 114 4 4 114 114 114 114 114 114 114 114 114 114 114 114 114 114 15 15 15 114 114 114 114 114 114 15 15 114 114 114 114 114 114 114 114 114 114 114 59
59 114 114 114 114 114 114 114 114 114 114 114 114 114 15 114 114 114 114 114 114 114 114 114 114 14 114 114 114 114 114 114 114 114 114 114 114 114 114 15 15 15 15 15 114 114 15 114 114 114 114 114 114 114 114 114 114 114 114 59
59 114 114 114 114 114 114 114 114 114 114 114 14 114 15 15 15 114 114 114 114 114 114 114 114 114 114 114 14 114 15 114 114 114 114 114 114 114 114 114 114 114 114 114 114 114 15 114 114 114 114 114 114 114 114 114 114 114 114 59
59 114 114 114 114 114 114 14 114 114 114 114 114 114 114 114 114 114 114 114 114 114 114 114 114 114 114 114 114 114 114 114 114 114 114 114 114 114 114 114 114 114 114 114 114 114 15 114 114 14 114 114 114 114 114 114 114 114 114 59
59 114 114 114 114 114 114 114 114 114 114 14 114 114 114 114 114 114 114 114 114 114 114 114 4 4 114 114 114 114 114 114 114 114 114 114 114 114 114 114 114 114 114 114 114 114 15 114 114 114 114 114 114 14 114 114 114 114 114 59
59 114 114 114 114 114 114 114 114 114 114 114 114 114 114 114 114 114 114 114 114 114 114 114 114 4 4 114 114 114 114 114 114 114 114 114 15 114 114 114 114 114 114 114 114 114 15 114 114 114 114 5 114 114 114 114 114 114 114 59
59 114 114 114 14 114 114 114 114 114 114 114 114 114 114 114 114 114 114 114 114 114 114 114 114 114 4 4 114 114 114 114 114 114 114 114 114 114 114 114 114 114 114 114 114 114 114 114 114 114 114 5 5 5 114 114 114 114 114 59
59 114 114 114 114 114 114 114 114 114 114 114 114 114 114 114 114 114 114 114 114 114 114 114 114 114 114 4 114 114 114 114 114 114 14 114 114 114 114 114 114 114 114 114 114 114 114 114 114 114 14 114 114 5 114 14 114 114 114 59
59 114 114 114 114 114 114 114 5 5 114 114 114 114 114 114 114 14 114 114 114 114 114 114 114 114 4 4 114 114 114 114 114 114 114 114 114 114 114 114 14 114 114 114 114 114 114 114 114 114 114 114 114 114 114 114 114 114 114 59
59 114 114 114 114 114 114 114 5 114 114 114 114 114 114 114 114 114 114 114 114 114 114 114 114 114 114 4 4 114 114 114 114 114 114 114 114 114 114 114 114 114 114 114 114 114 114 114 114 114 114 114 114 14 114 114 114 114 114 59
59 114 114 114 114 114 114 5 5 114 114 114 114 114 114 114 114 114 14 114 114 114 114 114 114 114 114 114 114 114 15 15 15 114 15 114 15 114 15 114 15 15 15 114 15 114 15 114 114 114 5 5 114 114 114 114 114 114 114 59
59 114 114 114 114 114 114 5 114 114 114 114 114 14 114 114 114 114 114 114 114 114 114 114 114 114 114 114 114 114 15 114 114 114 15 114 15 114 15 114 15 114 15 114 15 114 15 114 114 114 114 5 114 114 114 114 114 114 114 59
59 114 114 114 114 5 5 5 114 114 114 114 114 114 114 114 114 114 114 14 114 114 114 114 114 114 114 114 114 114 15 15 15 114 15 114 15 114 15 114 15 15 15 114 114 15 15 114 114 114 114 5 5 114 14 114 114 114 114 59
59 114 114 5 5 114 114 114 114 114 114 114 114 114 114 114 114 114 114 114 114 114 114 114 114 114 114 114 114 114 15 114 114 114 15 114 15 114 15 114 15 15 114 114 114 114 15 114 114 114 114 114 114 114 114 114 114 114 114 59
59 114 114 114 5 5 5 114 114 114 114 114 114 114 114 114 114 114 114 114 114 114 114 114 114 114 114 114 114 114 15 114 114 114 15 114 15 15 15 114 15 114 15 114 114 114 15 114 114 114 114 114 114 114 114 114 114 114 114 59
59 59 59 59 59 59 59 59 59 59 59 59 59 59 59 59 59 59 59 59 59 59 59 59 59 59 59 59 59 59 59 59 59 59 59 59 59 59 59 59 59 59 59 59 59 59 59 59 59 59 59 59 59 59 59 59 59 59 59 59