59 59 59 59 59 59 59 59 59 59 59 59 59 59 59 59 59 59 59 59 59 59 59 59 59 59 59 59 59 59 59 59 59 59 59 59 59 59 59 59 59 59 59 59 59 59 59 59 59 59 59 59 59 59 59 59 59 59 59 59
59 114 114 114 114 114 114 114 114 114 114 114 114 114 114 114 114 114 114 114 114 114 114 114 114 114 114 114 114 114 114 114 114 114 114 114 114 114 114 114 114 114 114 114 114 114 114 114 114 114 114 114 114 114 114 114 114 114 114 59
59 114 114 110 131 131 131 131 131 131 131 131 131 131 131 131 131 131 131 131 131 131 131 131 131 131 131 131 131 131 131 131 112 114 114 114 14 114 114 114 114 114 114 114 114 114 114 114 114 114 114 114 14 114 114 114 114 114 114 59
59 114 114 123 114 114 114 114 114 114 114 114 114 114 114 114 114 114 114 114 114 114 114 114 114 114 114 114 114 114 114 114 123 114 114 114 14 114 114 114 114 114 110 131 113 113 113 113 113 113 112 114 114 114 114 114 114 114 114 59
59 114 114 123 114 114 114 114 114 114 114 114 114 114 114 114 114 114 114 114 114 114 114 114 114 114 114 114 114 114 114 114 130 112 114 114 114 114 114 110 131 113 132 114 114 114 114 114 114 114 123 114 114 114 114 114 114 114 114 59
59 114 110 132 114 114 114 114 114 114 114 114 114 114 114 114 114 114 114 114 114 114 114 114 114 114 114 114 114 114 114 114 114 123 114 114 114 114 114 123 114 114 114 114 114 114 114 114 114 114 123 114 114 114 114 114 14 114 114 59
59 114 123 114 114 114 114 114 114 114 114 114 114 114 114 114 114 114 114 114 114 114 114 114 114 114 114 114 114 114 114 114 114 123 114 114 114 114 14 123 114 114 114 114 114 114 114 114 114 114 123 114 114 114 114 114 114 114 114 59
59 114 123 114 114 114 114 114 114 114 114 114 114 114 114 114 114 114 114 114 114 114 114 114 114 114 114 114 114 114 114 114 114 123 114 14 114 114 114 123 114 114 114 114 114 110 113 113 113 113 132 114 114 114 114 114 114 114 114 59
59 114 123 114 114 114 114 114 114 114 114 114 114 114 114 114 114 114 114 114 114 114 114 114 114 114 114 114 114 114 114 114 114 123 114 114 114 114 114 123 114 114 114 114 123 132 114 114 114 114 14 114 114 114 14 114 114 114 14 59
59 114 123 114 114 114 114 114 114 114 114 114 114 114 114 114 114 114 114 114 114 114 114 114 114 114 114 114 114 114 114 114 110 132 114 114 4 4 114 123 114 114 114 114 123 114 114 114 114 114 114 114 114 114 114 114 114 114 114 59
59 114 123 114 114 114 114 114 114 114 114 114 114 114 114 114 114 114 114 114 114 114 114 114 114 114 114 114 114 114 114 114 123 114 114 14 114 4 114 123 114 114 114 114 123 114 114 114 14 114 114 114 4 4 114 114 114 114 114 59
59 114 123 114 114 114 114 114 114 114 114 114 114 114 114 114 114 114 114 114 114 114 114 114 114 114 114 114 114 114 114 114 123 114 114 114 114 114 114 123 114 114 114 123 114 114 114 114 114 114 114 14 114 114 114 114 14 114 114 59
59 114 123 114 114 114 114 114 114 114 114 114 114 114 114 114 114 114 114 114 114 114 114 114 114 114 114 114 114 114 114 114 123 114 114 114 114 114 14 123 114 114 114 123 114 114 114 14 114 114 114 114 114 114 14 114 114 114 114 59
59 114 123 114 114 114 114 114 114 114 114 114 114 114 114 114 114 114 114 114 114 114 114 114 114 114 114 114 114 114 114 114 123 114 114 14 114 114 114 123 114 114 114 123 114 114 114 114 114 114 114 114 114 114 14 114 114 114 114 59
59 114 123 114 114 114 114 114 114 114 114 114 114 114 114 114 114 114 114 114 114 114 114 114 114 114 114 114 114 114 114 114 123 114 114 114 114 114 114 123 114 114 114 130 113 113 113 113 113 113 113 113 113 113 113 113 113 113 113 59
59 114 123 114 114 114 114 114 114 114 114 114 114 114 114 114 114 114 114 114 114 114 114 114 114 114 114 114 114 114 114 114 130 113 113 113 113 113 113 132 114 114 114 114 114 114 114 114 114 114 114 114 114 114 114 114 114 114 114 59
59 114 130 112 114 114 114 114 114 114 114 114 114 114 114 114 114 114 114 114 114 114 114 114 114 114 114 114 114 114 114 114 114 114 114 114 114 114 114 114 114 114 114 114 114 114 114 114 114 114 114 114 114 114 114 114 114 114 114 59
59 114 114 123 114 114 114 114 114 114 114 114 114 114 114 114 114 114 114 114 114 114 114 114 114 114 114 114 114 114 114 114 114 114 114 114 114 114 114 114 114 114 114 114 114 114 114 114 114 114 114 114 114 114 114 114 114 114 114 59
59 114 114 123 114 114 114 114 114 114 114 114 114 114 114 114 114 114 114 114 114 114 114 114 114 114 114 114 114 114 114 114 114 114 114 114 114 114 114 114 114 114 114 114 114 114 114 114 114 114 114 114 114 114 114 114 114 114 114 59
59 114 114 123 114 114 114 114 114 114 114 114 114 114 114 114 114 114 114 114 114 114 114 114 114 114 114 114 114 114 114 114 110 131 131 131 131 131 131 112 114 114 114 114 110 131 131 131 131 131 131 131 131 131 131 131 131 131 131 59
59 114 114 123 114 114 114 114 114 114 114 114 114 114 114 114 114 114 114 114 114 114 114 114 114 114 114 114 114 114 114 110 132 114 114 114 114 114 114 123 114 114 114 114 123 114 114 114 114 114 114 114 114 114 114 114 114 114 114 59
59 114 114 123 114 114 114 114 114 114 114 114 114 114 114 114 114 114 114 114 114 114 114 114 114 114 114 114 114 114 114 123 114 114 14 114 114 114 114 123 114 114 114 114 123 114 114 114 114 114 114 114 114 114 114 114 114 114 114 59
59 114 114 123 114 114 114 114 114 114 114 114 114 114 114 114 114 114 114 114 114 114 114 114 114 114 114 114 114 114 114 123 114 114 114 114 114 114 114 123 114 114 114 114 123 114 114 14 114 114 114 14 114 114 114 114 114 114 114 59
59 114 114 123 114 114 114 114 114 114 114 114 114 114 114 114 114 114 114 114 114 114 114 114 114 114 114 114 114 114 114 123 114 114 114 114 14 114 114 123 114 114 114 114 123 114 114 114 4 4 4 114 114 114 14 114 14 114 114 59
59 114 114 123 114 114 114 114 114 114 114 114 114 114 110 113 113 113 113 113 113 113 113 113 113 113 113 113 113 113 113 132 114 114 14 114 114 114 114 123 114 114 114 114 123 114 114 114 114 114 4 4 4 114 114 114 114 114 114 59
59 114 114 130 113 113 113 113 113 113 113 113 113 113 132 114 114 114 114 114 114 14 114 114 114 114 114 114 114 114 114 114 114 114 114 114 14 114 114 123 114 114 114 114 123 114 14 114 114 114 114 114 114 114 114 114 114 114 114 59
59 114 114 14 114 114 114 114 114 114 114 114 114 14 114 114 114 114 114 114 114 114 114 114 114 114 114 114 114 114 114 114 114 114 114 114 114 114 114 123 114 114 114 114 123 114 114 114 114 14 114 114 14 114 114 14 114 114 114 59
59 114 114 114 114 114 114 114 114 114 114 114 114 114 114 114 114 114 114 114 114 114 114 14 114 114 114 114 14 114 114 114 114 14 114 114 114 114 114 123 114 114 114 114 123 114 114 114 114 114 114 114 114 114 114 114 114 114 114 59
59 114 114 114 114 114 14 114 114 114 114 114 114 114 14 114 114 114 114 114 4 4 4 4 4 114 114 114 114 114 114 114 14 114 114 114 114 14 114 123 114 114 114 114 123 114 114 14 14 114 114 114 114 14 114 114 14 114 114 59
59 114 114 114 114 114 114 114 114 114 114 114 114 114 114 114 4 4 4 4 4 114 114 114 114 114 114 114 114 114 114 114 114 114 114 114 114 114 114 123 114 114 114 114 123 114 114 114 114 114 114 114 114 114 114 114 114 114 114 59
59 113 131 131 131 131 131 131 131 131 131 131 131 131 131 131 131 131 131 131 131 131 131 131 131 131 131 131 131 131 131 131 131 131 131 131 131 131 131 132 114 114 114 114 130 131 131 131 131 131 131 131 131 131 131 131 131 131 131 59
59 114 114 114 114 114 114 114 114 114 114 114 114 114 114 114 114 114 114 114 114 114 114 114 114 114 114 114 114 114 114 114 114 114 114 114 114 114 114 114 114 114 114 114 114 114 114 114 114 114 114 114 114 114 114 114 114 114 114 59
59 114 114 114 114 114 114 114 114 114 114 114 114 114 114 114 114 114 114 114 114 114 114 114 114 114 114 114 114 114 114 114 114 114 114 114 114 114 114 114 114 114 114 114 114 114 114 114 114 114 114 114 114 114 114 114 114 114 114 59
59 114 114 114 114 114 114 114 114 114 114 114 114 114 114 114 114 114 114 114 114 114 114 114 114 114 114 114 114 114 114 114 114 114 114 114 114 114 114 114 114 114 114 114 114 114 114 114 114 114 114 114 114 114 114 114 114 114 114 59
59 114 114 114 114 114 114 114 114 114 114 114 114 114 114 114 114 114 114 114 114 114 114 114 114 114 114 114 114 114 114 114 114 114 114 114 114 114 114 114 114 114 114 114 114 114 114 114 114 114 114 114 114 114 114 114 114 114 114 59
59 113 131 131 131 131 131 131 131 131 131 131 131 131 131 131 131 131 131 131 131 131 131 131 131 131 131 131 131 131 131 131 131 131 131 131 131 131 131 131 131 131 131 131 131 131 131 131 131 131 131 131 131 131 131 131 131 131 131 59
59 114 114 14 114 114 114 114 114 114 114 114 114 114 114 114 114 114 114 114 114 114 114 114 114 114 4 114 114 114 114 114 114 114 114 114 114 4 114 114 114 114 114 114 14 114 114 114 114 114 114 114 114 114 114 114 4 114 114 59
59 114 114 114 114 114 114 14 114 114 4 4 4 114 114 114 114 114 14 114 114 114 114 14 114 4 4 114 114 114 14 114 114 114 114 114 114 4 4 4 4 4 4 4 114 114 114 114 114 114 114 14 114 114 4 4 4 114 114 59
59 114 114 114 114 114 114 114 114 114 114 114 4 4 4 4 114 114 114 114 114 114 114 114 114 114 114 114 114 114 114 114 114 114 114 114 114 114 14 114 114 114 114 114 114 114 114 114 114 114 114 114 114 114 114 114 114 114 114 59
59 59 59 59 59 59 59 59 59 59 59 59 59 59 59 59 59 59 59 59 59 59 59 59 59 59 59 59 59 59 59 59 59 59 59 59 59 59 59 59 59 59 59 59 59 59 59 59 59 59 59 59 59 59 59 59 59 59 59 59