59 59 59 59 59 59 59 59 59 59 59 59 59 59 59 59 59 59 59 59 59 59 59 59 59 59 59 59 59 59 59 59 59 59 59 59 59 59 59 59 59 59 59 59 59 59 59 59 59 59 59 59 59 59 59 59 59 59 59 59
59 35 35 35 35 35 35 35 35 59 59 38 38 38 38 38 38 38 38 38 38 38 38 38 38 38 38 38 46 46 46 46 38 38 38 38 38 38 38 38 38 38 38 38 38 38 38 38 38 38 38 38 38 38 38 38 38 38 38 59
59 35 35 35 35 35 35 35 35 59 59 38 38 38 38 38 38 38 38 38 38 38 38 38 38 38 38 38 46 46 46 46 38 38 38 38 38 38 38 38 38 38 38 38 38 38 38 38 38 38 38 38 38 38 38 38 38 38 38 59
59 35 35 35 35 35 35 35 35 59 38 38 38 38 38 38 38 38 38 38 38 38 38 38 38 38 38 38 46 46 46 46 38 38 38 38 38 38 38 38 38 38 38 38 38 38 38 38 38 38 38 38 38 38 38 38 38 38 38 59
59 35 35 35 35 35 35 35 35 59 38 38 38 38 38 38 38 38 38 38 38 38 38 38 38 38 38 38 46 46 46 46 38 38 38 38 38 38 38 38 38 38 38 38 38 38 38 38 38 38 38 38 38 38 38 38 38 38 38 59
59 35 35 35 35 35 35 35 35 59 59 38 38 38 38 38 38 38 38 38 38 38 38 38 38 38 38 38 46 46 46 46 38 38 38 38 38 38 38 38 38 38 38 38 38 38 38 38 38 38 38 38 38 38 38 38 38 38 38 59
59 35 35 35 35 35 35 35 35 59 59 38 38 38 38 38 38 38 38 38 38 38 38 38 38 38 38 38 46 46 46 46 38 38 38 38 38 38 38 38 38 38 38 38 38 38 38 38 38 38 38 38 38 38 38 38 38 38 38 59
59 35 35 35 35 35 35 35 35 59 38 38 38 38 38 38 38 38 38 38 38 38 38 38 38 38 38 38 46 46 46 46 38 38 38 38 38 38 38 38 38 38 38 38 38 38 38 38 38 38 38 38 38 38 38 38 38 38 38 59
59 35 35 35 35 35 35 35 35 59 38 38 38 38 38 38 38 38 38 38 38 38 38 38 38 38 38 38 46 46 46 46 38 38 38 38 38 38 38 38 38 38 38 38 38 38 38 38 38 38 38 38 38 38 38 38 38 38 38 59
59 35 35 35 35 35 35 35 35 59 59 38 38 38 38 38 38 38 38 38 38 38 38 38 38 38 38 38 46 46 46 46 38 38 38 38 38 38 38 38 38 38 38 38 38 38 38 38 38 38 38 38 38 38 38 38 38 38 38 59
59 35 35 35 35 35 35 35 35 59 59 38 38 38 38 38 38 38 38 38 38 38 38 38 46 46 46 46 46 46 46 46 46 46 46 46 38 38 38 38 38 38 38 38 38 38 38 38 38 38 38 38 38 38 38 38 38 38 38 59
59 35 35 35 35 35 35 35 35 59 38 38 38 38 38 38 38 38 38 38 38 38 38 46 46 46 46 46 46 46 46 46 46 46 46 46 46 38 38 38 38 38 38 38 38 38 38 38 38 38 38 38 38 38 38 38 38 38 38 59
59 35 35 35 35 35 35 35 35 59 38 38 38 38 38 38 38 38 38 38 38 38 46 46 46 46 46 46 46 46 46 46 46 46 46 46 46 46 38 38 38 38 38 38 38 38 38 38 38 38 38 38 38 38 38 38 38 38 38 59
59 35 35 35 35 35 35 35 35 59 59 38 38 38 38 38 38 38 38 38 38 46 46 46 46 46 46 46 46 46 46 46 46 46 46 46 46 46 46 38 38 38 38 38 38 38 38 38 38 38 38 38 38 38 38 38 38 38 38 59
59 35 35 35 35 35 35 35 35 59 59 38 38 38 38 38 38 38 38 38 46 46 46 46 46 46 46 46 46 46 46 46 46 46 46 46 46 46 46 46 38 38 38 38 38 38 38 38 38 38 38 38 38 38 38 38 38 38 38 59
59 35 35 35 35 35 35 35 35 59 38 38 38 38 38 38 38 38 38 38 46 46 46 46 46 46 46 46 46 46 46 46 46 46 46 46 46 46 46 46 38 38 38 38 38 38 38 38 38 38 38 38 38 38 38 38 38 38 38 59
59 35 35 35 35 35 35 35 35 59 38 38 38 38 38 38 38 38 38 38 46 46 46 46 46 46 46 46 46 46 46 46 46 46 46 46 46 46 46 46 38 38 38 38 38 38 38 38 38 38 38 38 38 38 38 38 38 38 38 59
59 35 35 35 35 35 35 35 35 59 38 38 38 38 38 38 38 38 38 38 46 46 46 46 46 46 46 46 46 46 46 46 46 46 46 46 46 46 46 46 38 38 38 38 38 38 38 38 38 38 38 38 38 38 38 38 38 38 38 59
59 43 43 43 43 43 43 43 43 59 46 46 46 46 46 46 46 46 46 46 46 46 46 46 46 46 46 46 46 46 46 46 46 46 46 46 46 46 46 46 46 46 46 46 46 46 46 46 46 46 46 46 46 46 46 46 46 46 46 59
59 46 46 46 46 46 46 46 46 59 46 46 46 46 46 46 46 46 46 46 46 46 46 46 46 46 46 46 46 46 46 46 46 46 46 46 46 46 46 46 46 46 46 46 46 46 46 46 46 46 46 46 46 46 46 46 46 46 46 59
59 46 46 46 46 46 46 46 46 59 46 46 46 46 46 46 46 46 46 46 46 46 46 46 46 46 46 46 46 46 46 46 46 46 46 46 46 46 46 46 46 46 46 46 46 46 46 46 46 46 46 46 46 46 46 46 46 46 46 59
59 40 40 40 40 40 40 40 40 59 46 46 46 46 46 46 46 46 46 46 46 46 46 46 46 46 46 46 46 46 46 46 46 46 46 46 46 46 46 46 46 46 46 46 46 46 46 46 46 46 46 46 46 46 46 46 46 46 46 59
59 35 35 35 35 35 35 35 35 59 38 38 38 38 38 38 38 38 38 38 46 46 46 46 46 46 46 46 46 46 46 46 46 46 46 46 46 46 46 46 38 38 38 38 38 38 38 38 38 38 38 38 38 38 38 38 38 38 38 59
59 35 35 35 35 35 35 35 35 59 38 38 38 38 38 38 38 38 38 38 46 46 46 46 46 46 46 46 46 46 46 46 46 46 46 46 46 46 46 46 38 38 38 38 38 38 38 38 38 38 38 38 38 38 38 38 38 38 38 59
59 35 35 35 35 35 35 35 35 59 23 38 38 38 38 38 38 38 38 38 46 46 46 46 46 46 46 46 46 46 46 46 46 46 46 46 46 46 46 46 38 38 38 38 38 38 38 38 38 38 38 38 38 38 38 38 38 38 38 59
59 35 35 35 35 35 35 35 35 59 59 38 38 38 38 38 38 38 38 38 46 46 46 46 46 46 46 46 46 46 46 46 46 46 46 46 46 46 46 46 38 38 38 38 38 38 38 38 38 38 38 38 38 38 38 38 38 38 38 59
59 35 35 35 35 35 35 35 35 59 59 38 38 38 38 38 38 38 38 38 38 46 46 46 46 46 46 46 46 46 46 46 46 46 46 46 46 46 46 38 38 38 38 38 38 38 38 38 38 38 38 38 38 38 38 38 38 38 38 59
59 35 35 35 35 35 35 35 35 59 38 38 38 38 38 38 38 38 38 38 38 38 46 46 46 46 46 46 46 46 46 46 46 46 46 46 46 46 38 38 38 38 38 38 38 38 38 38 38 38 38 38 38 38 38 38 38 38 38 59
59 35 35 35 35 35 35 35 35 59 38 38 38 38 38 38 38 38 38 38 38 38 38 46 46 46 46 46 46 46 46 46 46 46 46 46 46 38 38 38 38 38 38 38 38 38 38 38 38 38 38 38 38 38 38 38 38 38 38 59
59 35 35 35 35 35 35 35 35 59 59 38 38 38 38 38 38 38 38 38 38 38 38 38 46 46 46 46 46 46 46 46 46 46 46 46 38 38 38 38 38 38 38 38 38 38 38 38 38 38 38 38 38 38 38 38 38 38 38 59
59 35 35 35 35 35 35 35 35 59 59 38 38 38 38 38 38 38 38 38 38 38 38 38 38 38 38 38 46 46 46 46 38 38 38 38 38 38 38 38 38 38 38 38 38 38 38 38 38 38 38 38 38 38 38 38 38 38 38 59
59 35 35 35 35 35 35 35 35 59 38 38 38 38 38 38 38 38 38 38 38 38 38 38 38 38 38 38 46 46 46 46 38 38 38 38 38 38 38 38 38 38 38 38 38 38 38 38 38 38 38 38 38 38 38 38 38 38 38 59
59 35 35 35 35 35 35 35 35 59 38 38 38 38 38 38 38 38 38 38 38 38 38 38 38 38 38 38 46 46 46 46 38 38 38 38 38 38 38 38 38 38 38 38 38 38 38 38 38 38 38 38 38 38 38 38 38 38 38 59
59 35 35 35 35 35 35 35 35 59 59 38 38 38 38 38 38 38 38 38 38 38 38 38 38 38 38 38 46 46 46 46 38 38 38 38 38 38 38 38 38 38 38 38 38 38 38 38 38 38 38 38 38 38 38 38 38 38 38 59
59 35 35 35 35 35 35 35 35 59 59 38 38 38 38 38 38 38 38 38 38 38 38 38 38 38 38 38 46 46 46 46 38 38 38 38 38 38 38 38 38 38 38 38 38 38 38 38 38 38 38 38 38 38 38 38 38 38 38 59
59 35 35 35 35 35 35 35 35 59 38 38 38 38 38 38 38 38 38 38 38 38 38 38 38 38 38 38 46 46 46 46 38 38 38 38 38 38 38 38 38 38 38 38 38 38 38 38 38 38 38 38 38 38 38 38 38 38 38 59
59 35 35 35 35 35 35 35 35 59 38 38 38 38 38 38 38 38 38 38 38 38 38 38 38 38 38 38 46 46 46 46 38 38 38 38 38 38 38 38 38 38 38 38 38 38 38 38 38 38 38 38 38 38 38 38 38 38 38 59
59 35 35 35 35 35 35 35 35 59 59 38 38 38 38 38 38 38 38 38 38 38 38 38 38 38 38 38 46 46 46 46 38 38 38 38 38 38 38 38 38 38 38 38 38 38 38 38 38 38 38 38 38 38 38 38 38 38 38 59
59 35 35 35 35 35 35 35 35 59 59 38 38 38 38 38 38 38 38 38 38 38 38 38 38 38 38 38 46 46 46 46 38 38 38 38 38 38 38 38 38 38 38 38 38 38 38 38 38 38 38 38 38 38 38 38 38 38 38 59
59 59 59 59 59 59 59 59 59 59 59 59 59 59 59 59 59 59 59 59 59 59 59 59 59 59 59 59 59 59 59 59 59 59 59 59 59 59 59 59 59 59 59 59 59 59 59 59 59 59 59 59 59 59 59 59 59 59 59 59