59 59 59 59 59 59 59 59 59 59 59 59 59 59 59 59 59 59 59 59 59 59 59 59 59 59 59 59 59 59 59 59 59 59 59 59 59 59 59 59 59 59 59 59 59 59 59 59 59 59 59 59 59 59 59 59 59 59 59 59
59 59 59 59 114 59 59 59 59 59 59 59 59 59 59 59 59 59 59 59 59 59 114 78 114 114 59 59 59 59 59 59 59 59 59 59 59 59 59 59 59 59 59 59 59 59 59 59 59 59 59 59 59 59 59 59 59 59 59 59
59 59 59 114 114 114 114 114 114 114 114 114 114 59 59 59 59 59 59 59 59 59 114 114 114 59 59 59 59 59 59 59 59 59 59 59 59 59 59 59 59 59 59 59 59 59 59 59 59 59 59 59 59 59 59 59 59 59 59 59
59 59 114 114 114 114 114 114 114 114 114 114 114 59 59 59 59 59 59 59 59 59 114 114 114 59 59 59 59 59 59 59 59 59 59 59 59 59 59 59 59 59 59 59 59 59 59 59 59 59 59 59 59 59 59 59 59 59 59 59
59 59 114 114 114 59 59 59 59 59 114 114 114 114 59 59 59 59 59 59 59 59 114 114 114 59 59 59 59 59 59 59 59 59 59 59 59 59 59 59 59 59 59 59 59 59 59 59 59 59 59 59 59 59 59 59 59 59 59 59
59 59 114 114 114 59 59 59 59 59 59 114 114 114 59 59 59 59 59 59 59 59 114 114 114 59 59 59 59 59 59 59 59 59 59 59 59 59 59 59 114 114 114 59 59 59 59 59 59 59 59 59 59 59 59 59 59 59 59 59
59 59 114 114 59 59 59 59 59 59 59 59 114 114 59 59 59 114 59 59 59 59 114 114 59 59 59 59 59 59 59 59 59 59 59 59 59 59 59 59 114 114 114 114 59 59 59 59 59 59 59 59 59 59 59 59 59 59 59 59
59 59 114 114 114 59 59 59 59 59 59 59 114 114 59 59 59 114 114 59 59 114 114 114 114 114 114 114 114 114 114 59 59 59 59 59 59 59 59 114 114 78 114 114 59 59 59 114 114 114 114 59 59 59 59 59 59 59 59 59
59 59 114 114 114 59 59 59 59 59 59 59 114 114 59 59 59 59 114 59 59 114 114 114 59 59 59 59 114 78 114 114 114 59 59 59 59 59 59 114 114 114 114 114 114 114 114 114 114 114 114 114 59 59 59 59 59 59 59 59
59 59 114 114 114 114 59 59 59 59 114 114 114 59 59 59 59 59 114 59 59 114 114 59 59 59 59 59 114 114 114 114 114 114 59 59 59 59 59 59 59 114 114 114 114 114 114 114 114 114 114 114 114 59 59 59 59 59 59 59
59 59 59 114 114 114 59 59 59 59 114 78 114 59 59 59 59 59 114 114 114 114 114 59 59 59 59 59 59 59 59 114 114 114 114 59 59 59 59 59 59 114 114 114 114 114 114 114 114 114 114 114 114 59 59 59 59 59 59 59
59 59 59 114 114 114 114 114 59 59 114 114 114 59 59 59 59 59 114 114 114 114 114 59 59 59 59 59 59 59 59 59 114 114 114 114 59 59 59 59 114 114 114 114 114 114 114 114 114 59 114 114 114 114 59 59 59 59 59 59
59 59 59 59 114 114 114 114 59 59 59 59 59 59 59 59 114 114 114 114 114 114 59 59 59 59 59 59 59 59 59 59 59 114 114 114 114 59 114 114 114 114 114 59 59 59 114 114 114 59 59 114 114 114 59 59 59 59 59 59
59 59 59 59 59 114 114 114 59 59 59 59 59 59 59 59 114 114 114 114 114 59 59 59 59 59 59 59 59 59 59 59 59 59 114 114 114 114 114 114 114 114 114 59 59 114 78 114 114 59 59 114 114 114 59 59 59 59 59 59
59 59 59 59 59 59 114 114 114 59 59 59 59 59 59 114 114 114 114 59 114 59 59 59 59 59 59 59 59 59 59 59 59 59 59 114 114 114 114 114 59 59 59 59 59 114 114 114 114 59 59 114 114 114 59 59 59 59 59 59
59 59 59 59 59 59 114 114 114 114 114 114 59 59 114 114 114 114 59 59 114 59 59 59 59 59 59 59 59 59 59 59 59 114 114 114 114 114 114 114 59 59 59 59 59 59 114 114 59 59 59 59 114 114 59 59 59 59 59 59
59 59 59 59 59 59 114 114 114 114 114 114 114 114 114 114 59 59 59 114 114 59 59 59 59 59 59 59 59 59 59 114 114 114 114 114 114 114 114 114 59 59 59 59 59 59 59 59 59 59 59 59 114 114 59 59 59 59 59 59
59 59 59 59 59 59 59 114 114 114 114 114 114 114 114 114 59 59 59 114 59 59 59 59 59 59 59 59 59 59 114 114 114 114 114 114 114 114 114 59 59 59 59 59 59 59 59 59 59 59 59 59 114 114 59 59 59 59 59 59
59 59 59 59 59 59 59 59 59 59 59 59 59 59 59 59 59 59 114 114 59 114 114 114 114 59 59 59 59 59 59 114 114 114 114 114 114 59 59 59 59 59 59 59 59 59 59 59 59 59 59 59 114 114 59 59 59 59 59 59
59 59 59 59 59 59 114 114 114 114 114 114 114 114 114 114 114 114 114 114 114 114 114 114 114 114 114 114 114 114 114 114 114 114 114 59 59 59 59 59 59 59 59 59 59 59 59 59 59 59 114 114 114 114 59 59 59 59 59 59
114 114 114 114 114 114 114 114 114 114 114 114 114 114 114 114 114 114 114 114 114 114 114 114 114 114 114 114 114 114 59 114 114 114 114 114 59 59 59 59 59 59 59 59 114 114 114 114 114 114 114 114 114 114 114 59 59 59 59 59
114 114 114 114 114 114 114 114 114 114 114 114 114 114 114 114 114 114 114 114 114 114 114 114 59 59 59 59 59 59 59 59 114 78 114 114 59 59 59 114 114 114 114 114 114 114 114 114 114 114 114 114 114 114 114 114 59 59 59 59
114 114 114 114 114 114 114 114 114 114 114 114 114 114 114 114 114 114 59 59 59 59 59 59 59 59 59 59 59 114 114 114 114 114 114 59 59 59 59 114 114 114 114 114 114 114 114 114 114 114 114 114 114 114 114 114 114 59 59 59
59 114 59 59 59 59 59 59 59 59 59 59 59 114 114 114 59 59 59 59 59 59 59 59 59 59 59 59 114 114 78 114 114 59 59 59 59 59 59 114 114 114 114 114 114 114 114 114 114 114 114 114 114 114 114 114 114 59 59 59
59 59 59 59 59 59 59 59 59 59 59 59 114 114 114 59 59 59 59 59 59 59 59 59 59 59 59 59 114 114 114 114 114 59 59 59 59 59 114 114 114 114 114 114 114 114 114 114 114 114 114 114 114 114 114 114 114 59 59 59
59 59 59 59 59 59 59 59 59 59 59 59 114 114 114 59 59 59 59 59 59 59 59 59 59 59 59 59 59 114 114 114 59 59 59 59 59 59 114 114 114 114 114 114 114 114 114 114 114 114 114 114 114 114 114 114 114 114 59 59
59 59 59 59 59 59 59 59 59 59 59 114 114 114 114 59 59 59 59 59 59 59 59 59 59 59 59 59 59 59 59 59 59 59 59 59 59 59 114 114 114 114 114 114 114 114 114 114 114 114 114 114 114 114 114 114 114 114 59 59
59 59 59 59 59 59 59 59 59 59 59 114 114 114 59 59 59 59 59 59 59 59 59 59 59 59 59 59 59 59 59 59 59 59 59 59 59 59 114 114 114 114 114 114 114 114 114 114 114 114 114 114 114 114 114 114 114 114 59 59
59 59 59 59 59 59 59 59 59 59 59 114 114 114 59 59 59 59 59 59 59 59 59 59 59 59 59 59 59 59 59 59 59 59 59 59 59 59 114 114 114 114 114 114 114 114 114 114 114 114 114 114 114 114 114 114 114 114 59 59
59 59 59 59 59 59 59 59 59 59 59 114 114 114 114 59 59 59 59 59 59 59 59 59 114 114 59 59 59 59 59 59 59 59 59 59 59 59 114 114 114 114 114 114 114 114 114 114 114 114 114 114 114 114 114 114 114 114 59 59
59 59 59 59 59 59 59 59 59 59 59 114 114 114 114 114 59 59 59 59 59 59 59 114 114 114 114 59 59 59 59 59 59 59 59 59 59 59 114 114 114 114 114 114 114 114 114 114 114 114 114 114 114 114 114 114 114 114 59 59
59 59 59 59 59 59 59 59 59 59 59 114 114 114 114 114 114 114 59 59 59 59 59 114 114 78 114 114 59 59 59 59 59 59 59 59 59 59 114 114 114 114 114 114 114 114 114 114 114 114 114 114 114 114 114 114 114 114 59 59
59 59 59 59 59 59 59 59 59 59 114 114 114 114 114 114 114 114 59 59 59 59 59 59 114 114 114 114 59 59 59 59 59 59 59 59 59 59 114 114 114 114 114 114 114 114 114 114 114 114 114 114 114 114 114 114 114 114 59 59
59 59 59 59 59 114 114 59 59 114 114 114 59 59 59 114 114 114 114 59 59 59 59 114 114 114 114 59 59 59 59 59 59 59 59 59 59 59 114 114 114 114 114 114 114 114 114 114 114 114 114 114 114 114 114 114 114 59 59 59
59 59 59 59 59 59 114 114 114 114 114 114 59 59 59 114 114 114 114 114 114 114 114 114 114 114 114 59 59 59 59 59 59 59 59 59 59 59 59 114 114 114 114 114 114 114 114 114 114 114 114 114 114 114 114 59 59 59 59 59
59 59 59 59 59 59 114 114 114 114 114 59 59 59 114 114 114 59 114 114 114 114 114 59 59 59 59 59 59 59 59 59 59 59 59 59 59 59 59 59 114 114 114 114 114 114 114 114 114 114 59 59 59 59 59 59 59 59 59 59
59 59 59 59 59 59 114 114 59 59 59 59 59 59 114 114 114 114 114 114 59 59 59 59 59 59 59 59 59 59 59 59 59 59 59 59 59 59 59 59 59 59 59 59 59 59 114 114 114 114 59 59 59 59 114 114 114 114 114 59
59 59 59 59 59 59 59 59 59 59 59 59 59 59 114 78 114 114 59 59 59 59 59 59 59 59 59 59 59 59 59 59 59 59 59 59 59 59 59 59 59 59 59 59 59 59 59 114 114 114 114 114 114 114 114 114 114 114 59 59
59 59 59 59 59 59 59 59 59 59 59 59 59 59 114 114 114 59 59 59 59 59 59 59 59 59 59 59 59 59 59 59 59 59 59 59 59 59 59 59 59 59 59 59 59 59 59 59 114 114 114 114 114 114 114 114 114 114 59 59
59 59 59 59 59 59 59 59 59 59 59 59 59 59 59 59 59 59 59 59 59 59 59 59 59 59 59 59 59 59 59 59 59 59 59 59 59 59 59 59 59 59 59 59 59 59 59 59 59 59 59 59 59 59 59 59 59 59 59 59