59 59 59 59 59 59 59 59 59 59 59 59 59 59 59 59 59 59 59 59 59 59 59 59 59 59 59 59 59 59 59 59 59 59 59 59 59 59 59 59 59 59 59 59 59 59 59 59 59 59 59 59 59 59 59 59 59 59 59 59
59 21 21 21 21 21 21 21 21 21 33 21 21 21 21 21 21 21 21 21 21 33 33 21 21 21 21 21 21 21 21 21 21 21 21 21 21 21 21 33 21 21 21 21 21 21 21 21 21 21 21 21 21 21 21 21 21 21 21 59
59 21 21 21 21 21 21 21 21 33 33 21 21 21 21 21 21 21 21 21 33 33 21 21 21 21 21 21 21 21 21 21 21 21 21 21 21 21 33 33 21 21 21 21 21 21 21 21 21 21 21 21 21 21 21 21 21 21 21 59
59 21 21 21 21 21 21 33 33 33 21 21 21 21 21 21 21 21 21 21 33 21 21 21 21 21 21 21 21 21 21 21 21 21 21 21 21 21 33 21 21 21 21 21 21 21 21 21 21 21 21 21 21 21 21 21 21 21 21 59
59 21 21 21 21 21 21 33 33 21 21 21 21 21 21 21 21 21 21 21 33 21 21 21 21 21 21 21 21 21 21 21 21 21 21 21 21 21 33 21 21 21 21 21 21 21 21 21 21 21 21 21 21 21 21 21 21 21 21 59
59 21 21 21 21 21 21 21 33 21 21 21 21 21 21 21 21 21 21 33 33 21 21 21 21 21 21 21 21 21 21 21 21 21 21 21 21 33 33 21 21 21 21 21 21 21 21 21 21 21 21 21 21 21 21 21 33 33 33 59
59 21 21 21 21 21 21 21 33 33 21 21 21 21 21 21 21 21 21 33 21 21 21 21 21 21 21 21 21 21 21 21 21 21 21 21 21 33 21 21 21 21 21 21 21 21 21 21 21 21 21 21 33 33 33 33 33 21 21 59
59 21 21 21 21 21 21 21 21 33 33 21 21 21 21 21 21 21 21 33 21 21 21 21 21 21 21 21 21 21 21 21 21 21 21 21 21 33 21 21 21 21 21 21 21 21 21 21 21 21 33 33 33 21 21 21 21 21 21 59
59 21 21 21 21 21 21 21 21 21 33 21 21 21 21 21 21 21 21 33 21 21 21 21 21 21 21 21 21 21 21 21 21 21 21 21 33 33 21 21 21 21 21 21 21 21 21 21 21 33 33 21 21 21 21 21 21 21 21 59
59 21 21 21 21 21 21 21 21 21 33 21 21 21 21 21 21 21 21 33 33 21 21 21 21 21 21 21 21 21 21 21 21 21 21 21 33 21 21 21 21 21 21 21 21 21 21 33 33 33 21 21 21 21 21 21 21 21 21 59
59 21 21 21 21 21 21 21 21 21 33 21 21 21 21 21 21 21 21 21 33 21 21 21 21 21 21 21 21 21 21 21 21 21 21 33 33 21 21 21 21 21 21 21 21 21 21 33 21 21 21 21 21 21 21 21 21 21 21 59
59 21 21 21 21 21 21 21 21 21 33 33 21 21 21 21 21 21 21 21 33 21 21 21 21 21 21 21 21 21 21 21 21 33 33 33 21 21 21 21 21 21 21 21 21 21 33 33 21 21 21 21 21 21 21 21 21 21 21 59
59 21 21 21 21 21 21 21 21 21 21 33 21 21 21 21 21 21 21 21 33 21 21 21 21 21 21 21 21 21 21 21 33 33 21 21 21 21 21 21 21 21 21 21 21 21 33 21 21 21 21 21 21 21 21 21 21 21 21 59
59 21 21 21 21 21 21 21 21 21 33 33 21 21 21 21 21 21 21 21 33 21 21 21 21 21 21 21 21 33 33 33 33 21 21 21 21 21 21 21 21 21 21 21 21 33 33 21 21 21 21 21 21 21 21 21 21 21 21 59
59 21 21 21 21 21 21 21 21 21 33 21 21 21 21 21 21 21 21 21 33 21 21 21 21 21 33 33 33 33 21 33 33 33 33 21 21 21 21 21 21 21 21 21 33 33 21 21 21 21 21 21 21 21 21 21 21 21 21 59
59 21 21 21 21 21 21 21 21 21 33 21 21 21 21 21 21 21 21 21 33 21 21 21 33 33 33 21 21 21 21 21 21 21 33 33 33 33 33 21 21 21 21 21 33 33 21 21 21 21 21 21 21 21 21 21 21 21 21 59
59 21 21 21 21 21 21 21 21 21 33 21 21 21 21 21 21 21 21 21 33 21 33 33 33 21 21 21 21 21 21 21 21 21 21 21 21 21 33 33 33 33 21 33 33 21 21 21 21 21 21 21 21 21 21 21 21 21 21 59
59 21 21 21 21 21 21 21 21 33 33 21 21 21 21 21 21 21 21 21 33 33 33 21 21 21 21 21 21 21 21 21 21 21 21 21 21 21 21 21 21 33 33 33 21 21 21 21 21 21 21 21 21 21 21 21 21 21 21 59
59 21 21 21 21 21 21 21 21 33 21 21 21 21 21 21 21 21 21 21 33 33 21 21 21 21 21 21 21 21 21 21 21 21 21 21 21 21 21 21 21 21 21 33 33 21 21 21 21 21 21 21 21 21 21 21 21 21 21 59
59 21 21 21 21 21 21 21 33 33 21 21 21 21 21 21 21 21 21 33 33 21 21 21 21 21 21 21 21 21 21 21 21 21 21 21 21 21 21 21 21 21 21 21 33 33 21 21 21 21 21 21 21 21 21 21 21 21 21 59
59 33 33 33 33 33 33 33 33 33 21 21 21 21 21 21 21 21 21 33 21 21 21 21 21 21 21 21 21 21 21 21 21 21 21 21 21 21 21 21 21 21 21 21 21 33 33 21 21 21 21 21 21 21 21 21 21 21 21 59
59 21 21 21 21 21 21 21 21 33 33 33 33 33 21 21 21 21 33 33 21 21 21 21 21 21 21 21 21 21 21 21 21 21 21 21 21 21 21 21 21 21 21 21 21 33 33 33 21 21 21 21 21 21 21 21 21 21 21 59
59 21 21 21 21 21 21 21 21 21 21 21 21 33 33 21 21 21 33 21 21 21 21 21 21 21 21 21 21 33 33 33 33 21 21 21 21 21 21 21 21 21 21 21 33 33 21 33 33 21 21 21 21 21 21 21 21 21 21 59
59 21 21 21 21 21 21 21 21 21 21 21 21 21 33 33 33 21 33 21 21 21 21 21 21 21 21 21 21 21 21 21 33 33 21 21 21 21 21 21 21 21 21 21 33 21 21 21 33 33 33 21 21 21 21 21 21 21 21 59
59 21 21 21 21 21 21 21 21 21 21 21 21 21 21 21 33 33 33 21 21 21 21 21 21 21 21 21 21 21 21 21 21 33 33 21 21 21 21 21 21 21 21 21 33 21 21 21 21 21 33 33 33 33 21 21 21 21 21 59
59 21 21 21 21 21 21 21 21 21 21 21 21 21 21 21 21 33 33 21 21 21 21 21 21 21 21 21 21 21 21 21 21 21 33 33 33 21 21 21 21 21 21 21 33 21 21 21 21 21 21 21 21 33 33 33 33 33 21 59
59 21 21 21 21 21 21 21 21 21 21 21 21 21 21 21 21 21 33 33 21 21 21 21 21 21 21 21 21 21 21 21 21 21 21 21 33 33 33 33 33 33 33 33 33 21 21 21 21 21 21 21 21 21 21 21 21 33 33 59
59 21 21 21 21 21 21 21 21 21 21 21 21 21 21 21 21 21 21 33 33 21 21 21 21 21 21 21 21 21 21 21 21 21 21 21 21 21 21 21 21 21 21 21 33 21 21 21 21 21 21 21 21 21 21 21 21 21 21 59
59 21 21 21 21 21 21 21 21 21 21 21 21 21 21 21 21 21 21 21 33 33 21 21 21 21 21 21 21 21 21 21 21 21 21 21 21 21 21 21 21 21 21 21 33 21 21 21 21 21 21 21 21 21 21 21 21 21 21 59
59 21 21 21 21 21 21 21 21 21 21 21 21 21 21 33 33 33 33 33 33 33 33 21 21 21 21 21 21 21 21 21 21 21 21 21 21 21 21 21 21 21 21 21 33 21 21 21 21 21 21 21 21 21 21 21 21 21 21 59
59 21 21 21 21 21 21 21 21 21 21 21 21 33 33 33 21 21 21 21 21 21 33 33 21 21 21 21 21 21 21 21 21 21 21 21 21 21 21 21 21 21 21 21 33 33 21 21 21 21 21 21 21 21 21 21 21 21 21 59
59 21 21 21 21 21 21 21 21 21 21 21 33 33 21 21 21 21 21 21 21 21 21 33 21 21 21 21 21 21 21 21 21 21 21 21 21 21 21 21 21 21 21 21 21 33 33 21 21 21 21 21 21 21 21 21 21 21 21 59
59 21 21 21 21 21 21 21 21 21 21 33 33 21 21 21 21 21 21 21 21 21 21 33 33 21 21 21 21 21 21 21 21 21 21 21 21 21 21 21 21 21 21 21 21 21 33 33 21 21 21 21 21 21 21 21 21 21 21 59
59 21 21 21 21 21 21 21 21 21 21 33 21 21 21 21 21 21 21 21 21 21 21 21 33 21 21 21 21 21 21 21 21 21 21 21 21 21 21 21 21 21 21 21 21 21 21 33 33 21 21 21 21 21 21 21 21 21 21 59
59 21 21 21 21 21 21 21 21 21 33 33 21 21 21 21 21 21 21 21 21 21 21 21 33 33 21 21 21 21 21 21 21 21 21 21 21 21 21 21 21 21 21 21 21 21 21 21 33 21 21 21 21 21 21 21 21 21 21 59
59 21 21 21 21 21 21 21 21 33 33 21 21 21 21 21 21 21 21 21 21 21 21 21 21 33 21 21 21 21 21 21 21 21 21 21 21 21 21 21 21 21 21 21 21 21 21 21 33 21 21 21 21 21 21 21 21 21 21 59
59 21 21 21 21 21 21 21 21 33 33 21 21 21 21 21 21 21 21 21 21 21 21 21 21 33 33 21 21 21 21 21 21 21 21 21 21 21 21 21 21 21 21 21 21 21 21 21 33 21 21 21 21 21 21 21 21 21 21 59
59 21 21 21 21 21 21 21 33 33 21 21 21 21 21 21 21 21 21 21 21 21 21 21 21 21 33 21 21 21 21 21 21 21 21 21 21 21 21 21 21 21 21 21 21 21 21 21 33 33 21 21 21 21 21 21 21 21 21 59
59 21 21 21 21 21 21 21 33 21 21 21 21 21 21 21 21 21 21 21 21 21 21 21 21 21 33 33 21 21 21 21 21 21 21 21 21 21 21 21 21 21 21 21 21 21 21 21 21 33 33 21 21 21 21 21 21 21 21 59
59 59 59 59 59 59 59 59 59 59 59 59 59 59 59 59 59 59 59 59 59 59 59 59 59 59 59 59 59 59 59 59 59 59 59 59 59 59 59 59 59 59 59 59 59 59 59 59 59 59 59 59 59 59 59 59 59 59 59 59