59 59 59 59 59 59 59 59 59 59 59 59 59 59 59 59 59 59 59 59 59 59 59 59 59 59 59 59 59 59 59 59 59 59 59 59 59 59 59 59 59 59 59 59 59 59 59 59 59 59 59 59 59 59 59 59 59 59 59 59
59 114 114 114 114 114 114 114 114 59 59 114 114 114 114 114 114 114 114 114 114 114 114 114 114 114 114 123 114 114 114 114 123 114 114 114 114 114 114 114 114 114 114 114 114 114 114 114 114 114 114 114 114 114 114 114 114 114 114 59
59 114 114 114 114 114 114 114 114 59 59 114 114 114 114 114 114 114 114 114 114 114 114 114 114 114 114 123 114 6 7 114 123 114 114 114 114 114 114 114 114 114 114 87 88 114 114 114 114 114 114 114 85 86 114 114 114 114 114 59
59 0 1 0 1 114 0 1 114 59 114 114 107 108 114 114 107 108 114 114 114 114 114 87 88 114 114 123 114 16 17 114 123 114 114 87 88 114 114 107 108 114 114 97 98 114 114 107 108 114 114 114 95 96 114 114 114 114 114 59
59 10 11 10 11 114 10 11 114 59 114 114 117 118 114 114 117 118 114 85 86 114 114 97 98 114 114 123 114 114 114 114 123 114 114 97 98 114 114 117 118 85 86 114 114 114 114 117 118 114 114 114 114 114 114 114 114 114 114 59
59 114 114 114 0 1 114 114 114 59 59 114 127 128 114 114 127 128 114 95 96 114 114 114 114 114 114 123 114 114 114 114 123 114 114 114 114 114 114 127 128 95 96 114 114 114 114 127 128 114 87 88 114 114 114 85 86 114 114 59
59 114 114 114 10 11 114 114 114 59 59 114 114 114 114 107 108 114 114 114 114 114 114 114 110 131 131 132 114 114 114 114 110 111 132 114 133 114 114 114 114 114 114 114 114 85 86 114 114 114 97 98 114 114 114 95 96 114 114 59
59 114 114 114 114 0 1 114 114 59 114 114 114 114 114 117 118 114 87 88 114 114 114 114 133 80 81 82 114 114 114 114 120 122 50 51 123 114 87 88 114 114 114 114 114 95 96 114 114 114 114 114 107 108 114 114 114 114 114 59
59 0 1 114 114 10 11 114 114 59 114 114 114 114 114 127 128 114 97 98 114 85 86 133 114 90 91 92 114 114 114 114 120 122 60 61 123 114 97 98 114 114 114 85 86 114 114 87 88 114 114 114 117 118 114 114 114 114 114 59
59 10 11 0 1 114 114 114 114 59 59 114 85 86 114 114 114 114 114 114 114 95 96 110 132 100 101 102 114 114 114 114 130 132 70 71 123 114 114 114 114 114 114 95 96 114 114 97 98 114 114 114 127 128 114 114 114 114 114 59
59 114 114 10 11 114 114 114 114 59 59 114 95 96 114 87 88 130 131 131 131 111 131 132 114 114 114 114 114 114 114 114 114 114 114 114 130 131 131 131 131 131 132 114 114 114 114 114 114 87 88 114 114 114 114 114 114 114 114 59
59 114 114 114 0 1 0 1 114 59 114 114 114 114 114 97 98 114 54 55 56 123 114 114 114 114 114 114 114 114 114 114 114 114 114 114 114 114 114 54 55 56 114 114 114 114 114 114 114 97 98 114 114 114 85 86 114 114 114 59
59 0 1 114 10 11 10 11 114 59 114 114 107 108 114 114 114 114 64 65 66 133 114 114 114 114 114 114 114 114 114 114 114 114 114 114 114 114 114 64 65 66 133 114 114 107 108 114 114 114 114 85 86 114 95 96 114 114 114 59
59 10 11 114 114 0 1 114 114 59 59 114 117 118 114 114 114 133 74 75 76 114 114 114 114 114 114 114 114 114 114 114 114 114 114 114 114 114 114 74 75 76 123 114 114 117 118 114 114 114 114 95 96 114 114 114 114 114 114 59
59 114 0 1 114 10 11 114 114 59 59 114 127 128 114 114 114 130 131 112 114 114 114 114 114 114 114 114 114 114 114 114 114 114 114 114 114 114 114 114 114 114 123 114 133 127 128 133 114 114 110 132 114 130 112 114 114 114 114 59
59 114 10 11 114 0 1 114 114 59 114 114 114 114 114 114 85 86 114 123 114 114 114 114 114 114 114 114 114 114 114 114 114 114 114 114 114 114 114 114 83 84 123 114 123 83 84 123 114 114 123 54 55 56 123 114 114 114 114 59
59 114 114 114 114 10 11 114 114 59 114 114 114 114 114 114 95 96 114 123 114 114 114 114 114 114 114 114 114 114 114 114 114 114 114 114 114 114 114 114 93 94 123 114 123 93 94 123 114 114 123 64 65 66 123 114 114 114 114 59
59 114 114 114 114 114 114 114 114 59 131 131 131 131 131 131 131 131 131 132 114 114 114 114 114 114 114 114 114 114 114 114 114 114 114 114 114 114 114 114 103 104 130 131 132 103 104 130 131 131 132 74 75 76 130 131 131 131 131 59
59 114 114 114 114 114 114 114 114 59 114 114 114 114 114 114 114 114 114 114 114 114 114 114 114 114 114 114 114 114 114 114 114 114 114 114 114 114 114 114 114 114 114 114 114 114 114 114 114 114 114 114 114 114 114 114 114 114 114 59
59 114 114 114 114 114 114 114 114 59 114 114 114 114 114 114 114 114 114 114 114 114 114 114 114 114 114 114 114 114 114 114 114 114 114 114 114 114 114 114 114 114 114 114 114 114 114 114 114 114 114 114 114 114 114 114 6 7 114 59
59 114 114 114 114 114 114 114 114 59 114 114 114 114 114 114 114 114 114 114 114 114 114 114 114 114 114 114 114 114 114 114 114 114 114 114 114 114 114 114 114 114 114 114 114 114 114 114 114 114 114 114 114 114 114 114 16 17 114 59
59 114 114 114 114 114 114 114 114 59 114 114 114 114 114 114 114 114 114 114 114 114 114 114 114 114 114 114 114 114 114 114 114 114 114 114 114 114 114 114 114 114 114 114 114 114 114 114 114 114 114 114 114 114 114 114 114 114 114 59
59 114 114 114 114 114 114 114 114 59 131 131 131 131 131 131 112 52 53 114 114 114 114 114 114 114 114 114 114 114 114 114 114 114 114 114 114 114 114 114 130 131 131 111 131 131 131 131 131 131 131 131 131 131 131 131 131 131 131 59
59 114 114 114 114 114 114 114 114 59 114 114 114 114 114 114 133 62 63 114 114 114 114 114 114 114 114 114 114 114 114 114 114 114 114 114 114 114 114 114 54 55 56 123 114 114 114 114 114 114 114 114 114 114 114 114 114 114 114 59
59 114 2 3 114 2 3 114 114 59 114 114 114 114 114 114 114 72 73 114 114 114 114 114 114 114 114 114 114 114 114 114 114 114 114 114 114 114 114 114 64 65 66 123 114 114 114 114 114 114 114 114 114 114 114 114 114 114 114 59
59 114 12 13 114 12 13 114 114 59 59 114 85 86 114 114 130 131 131 112 114 114 114 114 114 114 114 114 114 114 114 114 114 114 114 114 114 114 114 114 74 75 76 123 114 114 114 107 108 114 114 114 107 108 114 114 114 114 114 59
59 114 114 114 114 114 114 2 3 59 59 114 95 96 114 85 86 114 114 130 112 114 114 114 114 114 114 114 114 114 114 114 114 114 114 114 114 114 114 110 131 132 114 133 114 114 114 117 118 114 105 106 117 118 105 106 114 114 114 59
59 114 114 114 2 3 114 12 13 59 114 114 114 114 114 95 96 114 85 86 130 112 114 114 114 114 114 114 114 114 114 114 114 114 114 114 114 114 110 132 114 114 114 114 114 114 114 127 128 114 115 116 127 128 115 116 114 114 114 59
59 2 3 114 12 13 2 3 114 59 114 114 107 108 114 114 114 114 95 96 114 130 112 114 114 114 114 114 114 114 114 114 114 114 114 114 114 110 132 114 114 114 114 105 106 114 114 114 114 114 105 106 105 106 114 114 114 114 114 59
59 12 13 2 3 114 12 13 114 59 59 114 117 118 114 114 107 108 114 114 114 114 130 112 114 114 114 114 114 114 114 114 114 114 114 114 110 132 114 114 114 114 114 115 116 114 114 105 106 114 115 116 115 116 107 108 114 114 114 59
59 114 114 12 13 114 114 114 114 59 59 114 127 128 114 114 117 118 114 114 85 86 114 130 131 131 131 112 114 114 114 114 110 131 131 131 132 114 114 114 107 108 114 114 114 114 114 115 116 114 107 108 114 114 117 118 114 114 114 59
59 2 3 114 114 2 3 114 114 59 114 114 114 114 114 114 127 128 114 114 95 96 114 114 114 114 114 123 114 114 114 114 123 105 106 114 114 105 106 114 117 118 114 114 114 114 107 108 114 114 117 118 114 105 106 128 114 114 114 59
59 12 13 114 114 12 13 114 114 59 114 114 114 107 108 114 114 114 114 114 114 114 114 114 114 114 114 123 114 114 114 114 123 115 116 114 114 115 116 114 127 128 105 106 114 114 117 118 114 114 127 128 114 115 116 114 114 114 114 59
59 114 114 114 114 114 2 3 114 59 59 114 114 117 118 114 114 114 114 114 114 107 108 114 114 114 114 123 114 114 114 114 123 114 114 114 114 114 114 114 114 114 115 116 105 106 127 128 114 114 105 106 114 114 114 114 114 114 114 59
59 114 114 2 3 114 12 13 114 59 59 114 114 127 128 114 114 107 108 114 114 117 118 114 114 114 114 123 114 114 114 114 123 114 105 106 114 107 108 114 114 114 114 114 115 116 114 114 114 114 115 116 114 114 114 114 114 114 114 59
59 114 114 12 13 114 2 3 114 59 114 114 114 114 114 114 114 117 118 114 114 127 128 114 114 114 114 123 114 114 114 114 123 114 115 116 114 117 118 105 106 114 114 114 114 114 105 106 114 107 108 114 114 105 106 114 114 114 114 59
59 114 114 114 2 3 12 13 114 59 114 114 114 114 114 114 114 127 128 114 114 114 114 107 108 114 114 123 114 6 7 114 123 114 114 114 114 127 128 115 116 114 107 108 114 114 115 116 114 117 118 114 114 115 116 114 114 114 114 59
59 114 114 114 12 13 114 114 114 59 59 114 114 114 114 114 114 114 114 114 114 114 114 117 118 114 114 123 114 16 17 114 123 114 114 114 114 114 114 114 114 114 117 118 114 114 114 114 114 127 128 114 114 114 114 114 114 114 114 59
59 114 114 114 114 114 114 114 114 59 59 114 114 114 114 114 114 114 114 114 114 114 114 127 128 114 114 123 114 114 114 114 123 114 114 114 114 114 114 114 114 114 127 128 114 114 114 114 114 114 114 114 114 114 114 114 114 114 114 59
59 59 59 59 59 59 59 59 59 59 59 59 59 59 59 59 59 59 59 59 59 59 59 59 59 59 59 59 59 59 59 59 59 59 59 59 59 59 59 59 59 59 59 59 59 59 59 59 59 59 59 59 59 59 59 59 59 59 59 59